1111111
1P00101
1000101
10C0101
10E01C1
1111111
