1111111
1P00001
1000001
1000111
1C01E11
1111111
