11111111111111
1P0C0C000000E1
10001100000001
10001100000001
1000000C000001
100C1100000001
10001100000001
100000C00C0001
11111111111111
