11111111111111
1P0000000000E1
10001100000011
10001100000011
1000000C000011
100C1100000011
10001100000011
100000C0000011
11111111111111
