11111111111
1P000000001
10011111001
10000001C01
11111001001
10000001001
10100011111
10000000001
101001111C1
101000000E1
11111111111
