11111111111
1P000000001
10011111001
10000001C01
10100011111
101C0111101
101000000E1
11111111111
