1111111
1P000P1
1000001
1000E01
1000C01
1111111
