1111111
1P00001
1000001
1000001
1000E01
1111111
