1111111
1000001
1000001
1000E01
1000C01
1111111
