111111111
1P0000001
10000C001
100000001
10C000001
100000E01
111111111
