111111111
1P0000011
10000C011
100000011
10C000011
100000E11
111111111
